111111111111111111111
100000000000000000001
101101111010111101101
101101111010111101101
100000000000000000001
101101011111110101101
100001000010000100001
111101111010111101111
000101000000000101000
111101011101110101111
000000010000100000000
111101011111110101111
000101000000000101000
111101011111110101111
100000000010000000001
101101111010111101101
100100000000000001001
110101011111110101011
100001000010000100001
100000000000000000001
111111111111111111111